XXXXXXXX22XXXXXXXX
X     WI        SX
X  B2 WI         X
X  B0 WI         X
X  B1 WI     B2  X
X     WI         X
XWWWWWWI         X
XOOOOOOXH1       1
X      X         1
X      XXXXIIIIIIX
2       H2XWWWWWWX
2         XW     X
X         OW     X
X         OW     X
X   B1    OW   B2X
X         OW   B0X
XS        OW   B1X
XXXXXXXX11XXXXXXXX